dcf: erx
nuc: msc tly kej
hzd: sbh ubl ppb
fiu: oox
qnc: cde mrw
koq: gor xza rnq gbm
fly: ndm xvx klz azh
aem: kvs mus
zwv: ens cvs xiy
sjg: pif rhy hzi ojk tpv urz fcm gch civ xpw rzm vpo rzb akb inp gee vte rzf ovi ndb
jzi: pes iim
hir: jue fmt
got: pes
vtl: htu jqc glb rao lvl
cvs: klu zqc
fsq: ptc ogo ghm mbw wsd btn fly wwa vtl doi lpt aci
mue: nmw ojz scq ybv
mzk: ysr you dpt hbn
civ: emg nit wcf vex zpq
ywp: bbm urc gqu
vgz: mhh bbm urc
gna: emy pes
nrq: yfw gyb lmp
ocs: lbd tfc
asd: out
owc: dac slf
aci: nhn opx
yuj: kns
zon: irl ftj hiv
cez: uir
wlt: lbd sjg ocr mjo
bew: icg fhz qfy
gun: paj gct alg cfs
uxi: wgm wbk
etm: qnc jwj tly msc kej
jwj: mrw
ibe: wou hiq
gbm: njo zwv lzy
lwi: uyd vju
dar: gip ffr xoh
jjz: zrv
rzm: emg nit wcf
ybn: pes emy
ndb: goh qvs lub
paj: sjg lbd tfc ocr
tiq: mja muj wwp
lmp: iei nch pgg pxq mih bic gto jlb bxu erw hwc fts uvq kmm nru jyu tke
sxx: jzi
loz: ifp dot
kyb: wmr cfs alg gct paj
kyq: qrn qvb kuu
qoe: gjm
ufj: kyb crm tkp
ctg: oua umz qpe sup
hwf: xwp qaa dsm kih
res: vyb esw ouu loz
mih: fjq jhz
wou: yem erx
dhu: ied cfm zry
ptc: nhn opx myo
hlh: ybo pfw bmt
vdl: dpt you ysr fsq
ndr: cmv
fse: cqu gks
esk: chy fjh ble bso
uyj: mdy
lye: oua
mhi: out
bow: pes emy
pfr: hir
rzb: dvq nnc mtt uyj
rau: ybo
grr: ocr mjo
kdd: out
tvz: bjn ctg jbo tzz
xke: qpd ybn
vrf: scq noy nmw ybv
ffr: ied zry
eds: gjm vsu lxj
bpv: ecr gnj kzh ibe rso
jyc: wcr sbq
xis: out
vte: pfy
xza: lzy zwv erp njo
kfd: kdp rio
ybv: den
sjj: wdr oak kvn
bic: dar shc
ane: dot ifp cnj
gks: qpd bow ybn
ymr: ndh gyb
btn: jqc
wtk: ovc htf
tly: csd
isv: vgz zbv
hwr: abq asd
ojk: goh qvs
mog: tfc mjo
rvp: fri lwn fmw pfy xwa
dsm: iim
rem: giq rle eud koq
owi: xvx azh
utn: hwf
kej: cde
kmm: qrn
opx: isv
mdi: mbc hgl owc
zcs: dde kda
hid: dde
lkt: ndh lmp lhg
znh: myl kng que
tmc: mxc wlt
jwt: mbc owc srk
wag: hwf bpi qmy
wgy: mrh gte
dac: yks muw zhh rps
tvi: jne zhs twk
twa: dpt you ysr
cde: out
mdy: cfv
new: bir mag rvu
gee: sxz jjz
xxj: gvb xry isv
cqd: kda ntk dde
ecr: dcf wmk hiq
mhj: djd
akb: jjz sxz cyg
zku: dde
sny: dde
nlj: mja muj
xsn: zrv cqd
umz: kda
cnj: etk rme wtv
gjh: ctg tzz jbo
nit: qhl end
cqu: qpd
uxt: vyi adq zon smd
ydn: ndh lhg gyb
ove: rhw crh nry
bfp: esk mov
eef: ryk
xch: dpt hbn ysr fsq you
udi: war
nbp: yog cff
iet: foc kyr xis qxt
mfm: new tfn
kzd: sbq sny
pxq: srk mbc hgl
vvc: qfy
ida: ozp ftm
jyu: kuu qrn zhk
six: hbn
eus: bir
emw: cmv res
mdk: out
guj: uir xnc lut
rhy: tbb xsn jjz
yqi: ovc
hwc: qvb
uyd: slw mov mrn
fri: iik xxy zku
vyi: irl ftj iet
rhg: got gqj ksn
irl: kyr
war: xke gks lav cqu fcd
bey: tfn
fmw: iik
lbd: pif hzi rvp ojk tpv gch fcm civ xpw cgj rzm wwx vpo rzb akb gee inp vte ndb ovi rzf
slw: fjh ble
xxt: muj
bcc: ntk dde
vyb: ifp
zcw: ntk kda
rso: hiq hde wmk wou
adq: ftj irl iet
ovk: kda dde
cff: qmy
dof: out
icg: fse war
kjl: gqj ksn got eht
tdp: tzz lye
ksn: pes
jpr: ksb upj
ouu: ifp dot
bzt: ryk
qdx: tkb nfg hwr osj dfq
smd: yzu hiv irl
mjo: wwx cgj rzm vpo gee inp ndb rzf ovi vte rhy pif urz tpv ojk fcm
ilf: rji bpv
ajt: sfu
wsd: fiu ilf oin vto aqy
uir: kzd jyc
dot: wtv grr etk
wgm: obn mhj
cdz: dcr ebj kai
yez: rjd
que: vky
lxj: yuu
jlb: vet spv
zhh: hbn dpt ysr fsq
vws: cdz dhx
ojz: den
kda: bew kxr wms gfx qut tdn uok eef ngh nsw kbs eti ebe sqr lce dtm vvc oxj qgq bzt fyo aem
fyi: lxj ckh
tbd: ygf
wav: pfw bmt ybo tam
vxt: hgl srk
qhl: kda
mag: lhg yfw lmp gyb ndh
mus: ovc qbm
cgj: awf
giq: tml yuj txb rvs
bcu: myo opx xxj
oci: gyb lmp yfw lhg
wmr: tfc sjg
zhs: raj qdx mmr
ozp: eym gzm xch
twk: raj vjb
qvs: tvz tdp
oin: oox rji bpv
htu: ovd afo mzo
erp: xiy ens pre
jif: mjo lbd tfc ocr
tre: adq zon
wcf: zcs qhl end
pgg: hzd jhz xek
ubl: sas exd six vdl
pre: zqc jif klu fek
ovr: ndr koq yez
nge: oak
hiv: xis qxt kyr
dfq: kdd
ghm: ilf fiu vto oin aqy
ysr: fly doi bns lpt aci ghm dhn owi dvw wwa vtl nab fdh ptc bcu btn
yks: fsq dpt
mrn: kfd
tam: ytx bpk fmv
glb: mzo afo ovd
zbw: ndh yfw
mja: hbn dpt you fsq ysr
zqc: sjg
lag: wgy omt kai ebj
jta: jma eym
qmy: dsm xwp qaa
ndh: kmm pgg kyq bxu zko nru bic vxt
doi: sit vwq
jbo: ran
cfv: kda dde
fft: yna kzd
spv: htv ida qtz
mbw: vto fiu
qxt: out
mhh: mdk dof
zry: fdm twa xga
pob: new tfn eus
jdr: lmp gyb
fyo: pbc ryk wny
sjo: out
dtm: vob mxx lda
chy: kdp apw rio
xiy: klu
htf: glm xmy spz rhg
vky: pes iim
zrv: ntk
llo: iqy zry qcf ied cfm
urc: mdk
dgn: htf
erx: out
frm: fcd
tjr: twk czl
gjm: xxt yuu fbe
msc: csd cde
ocz: que myl kng
nch: eds
rak: rnq gbm xza
gqm: pes emy iim
jhz: ppb
mzo: nuc
tbb: bcc
qaa: iim emy pes
dma: ysr dpt
rio: lhg yfw
vph: tml txb yuj
xpw: goh
ngh: dgn mus yqi
qvb: mzk dma oxc
gqu: dof rue
egn: ebj dcr wgy
myl: vky jzi gna
svr: slo rem ovr xao oyc
xmy: got
lce: gnu ocz dry
vej: tfn
qpe: dde
ebv: tdl cfv zcw ovk
wnw: oci djd
bpi: qaa dsm
vwq: twk czl zhs
kbs: gnu wyd znh
sas: dpt fsq ysr
exd: dpt fsq ysr you
oak: zbw nrq lkt
qdh: pvq
yuu: wwp mja muj
cuj: muw
dry: que kmv kng sxx
cfs: ocr sjg tfc mjo
xwp: iim pes
jma: dpt ysr fsq you
zbv: mhh bbm gqu
lub: pyb gjh tdp
dpt: nab lpt wwa bns vtl owi wsd dvw ptc dhn
anl: ajt tmc
ngk: qnc jwj
nfg: asd
azh: ltu
ksb: ane esw vyb
xao: pfr vws eud jwm emw tbd owq vph koq jpr yez ejp rak
ovd: ngk etm
pfy: iik pai hid zku
bir: lmp yfw
dhn: sit whc vwq
muw: hbn you fsq
eud: gor rnq
fjh: apw
pvi: rao htu glb
rhw: wgm qzh
rjd: vyb loz
hde: diq
bbg: lxj ckh
ytp: wdr
cmv: loz ouu esw
wcr: kda dde
gzm: hbn dpt fsq ysr
you: pvi doi bns ghm
dcr: mrh vts
zfo: bfp vju
lhg: nch iei nei pxq vxt zko gto fts kyq nru jyu jwt
szs: tfn eus
rvs: kns vhs ufj
kng: vky jzi
eht: emy
eym: you dpt hbn
ehe: mxc wlt sfu
dvw: klz xvx
gct: mjo ocr sjg
djd: lmp gyb yfw
rme: ocr sjg lbd
pvq: zcw cfv ovk tdl
aun: yog
ogo: tvi
tzz: sup
rue: out
sfu: ocr tfc sjg
pah: gqu vkc urc
rvu: lmp lhg yfw ndh
klz: uxt tre
zko: xtf dar nwv shc
fmt: ehe
ryk: hvu
xxy: kda ntk
kxr: mus wtk kvs dgn
qiz: xiy pre cvs
bpk: xbd hel
mzc: scq
uok: pbc
erw: nwv shc
nab: nhn xxj myo
yem: out
ifp: grr mog
wbt: frm
wny: hvu tlh
gte: ocr
gvb: sqp ywp pah
fcm: fri lwn
xwa: xxy iik zku hid
laj: ckh gjm vsu
oox: ecr kzh
wms: znh
sbh: vdl six exd sas
gnu: kng
mxx: utn wag
mbc: cuj cdn
fbe: wwp
inp: uyj dvq nnc
xvx: uxt
hvu: iim emy
rcc: ndh lmp lhg yfw
qut: lda aun
xtf: gip llo xoh ffr
wwx: vex
ovi: guj cez awf vlb
nsw: qfy udi wbt
lut: kzd jyc yna
kuu: mzk dma oxc
xbd: ndh lmp lhg yfw
nei: xek
lav: ybn
fcd: qpd ybn
sup: ntk
oxj: dgn wtk
wtv: ocr sjg tfc mjo
pif: lwn fmw xwa
qcf: twa shn fdm xga
wbk: wnw mhj bdl
crm: wmr
obn: djd oci
noy: rcc
mrw: out
tfc: xpw ndb vpo inp rzm pif
lzy: xiy pre ens
qrn: dma oxc qbg
wwp: fsq hbn dpt
klu: tfc
ebj: gte mrh ocs
ran: kda
sxz: bcc
czl: mmr raj
zpq: end zcs
ckh: nlj xxt yuu tiq
sit: zhs czl twk
fdm: you
qgq: wny ryk pbc
yfw: jyu gto zko kyq pxq mih kmm hwc mdi fts nei
muj: you
rao: afo
xga: fsq hbn
awf: lut fft xnc
xek: ppb sbh
afo: nuc etm ngk
alg: sjg mjo
rxl: hbn ysr you
dhx: ebj dcr kai wgy
jqc: mzo
bjn: ran qpe
hjt: ndh
rji: rso ibe ecr gnj
foc: out
ndm: ltu uxt
xoh: zry iqy cfm qcf ied
xnc: kzd
ejp: egn lag dhx
dem: cfs wmr gct
tlh: pes
sbq: ntk kda
tpv: vlb guj
nry: qzh
mtt: ebv mdy pvq
bdl: ymr oci djd
mov: chy
tml: ufj kns
gyb: nei mdi nch iei pxq mih zko gto vxt bic aid hwc bxu erw uvq kyq nru jwt tke
raj: tkb nfg hwr dfq
ens: zmj jif zqc klu fek
vpo: dvq qdh nnc mtt
txb: vhs kns
tkb: abq
diq: out
kns: crm kyb dem
whc: jne twk
kih: pes iim emy
ygf: jue fmt anl
cfm: xga fdm shn
slf: rxl muw rps
omt: vts gte
qpt: oak
dvq: ebv myj
sqp: urc
nmw: hjt
ftm: gzm xch
tkp: paj cfs wmr
vex: end
myj: cfv zcw tdl
slo: rak vph ejp jwm vws
apw: lmp gyb lhg yfw
yvj: nry mup
oxc: ysr you dpt hbn
jlt: vju uyd
tdl: ntk
gfx: wyd
fdh: htu jqc glb lvl rao
goh: gjh
fjq: ppb ubl
fek: ocr tfc lbd
nru: fyi eds qoe laj
oyc: tbd vph vws emw jpr giq rak rle eud ndr jwm ejp
uvq: fia
lda: cff utn yog
shc: xoh ffr dhu gip
fts: laj bbg
tke: vet fia spv
kvs: htf qbm
zmj: mjo tfc sjg ocr
pfw: bpk
qfy: fse war frm
vts: mjo sjg tfc ocr
qtz: jta
upj: loz vyb ane ouu
gch: cyg xsn
lpt: azh xvx klz
emg: qhl zcs
rps: fsq hbn
vlb: xnc
vkc: rue mdk
vjb: dfq osj hwr tkb nfg
kvn: nrq zbw
hel: gyb lmp lhg ndh
glm: eht
vju: slw mrn mov esk
nwv: xoh ffr dhu gip llo
gor: zwv erp njo
yog: hwf qmy bpi
osj: kdd asd abq
srk: dac cuj
kdp: yfw lmp ndh
iei: vet
csd: out
gto: zhk qrn
mup: wbk qzh
owq: ygf vss
rnq: zwv qiz
hbn: lpt fly doi owi ogo fdh nab wsd pvi ptc mbw
ppb: six exd
mmr: osj
pai: dde ntk
ocr: hzi rhy tpv ojk fcm gch xpw civ wwx cgj rzm vpo gee inp rzb ndb ovi rzf vte
nnc: pvq ebv myj
xry: vgz sqp
iim: kxf vrf pob hlh szs bey qpt mfm nge ill vej wut lhn sjj jlt wav ffw rau mue
bmt: elf fmv aqg ytx
pbc: tlh gqm
end: ntk
vss: jue fmt
aqy: oox
ltu: smd vyi
bxu: hzd
zhk: qbg mzk
yos: mup rhw
vsu: fbe xxt tiq nlj
ebe: vob nbp mxx
htv: jta ozp
wdr: lkt zbw
wmk: yem sjo erx
gnj: dcf
vob: utn cff wag
kai: ocs
lvl: ovd afo
ybo: elf fmv aqg ytx
hiq: erx diq sjo yem
gqj: emy iim pes
ill: ybv nmw
sqr: wbt qfy fhz
kmv: jzi
spz: gqj
tzk: ysr fsq dpt
ytx: jdr ydn
abq: out
yna: sbq
kxf: nry rhw uxi
aqg: hel jdr
yzu: mhi qxt kyr foc
kyr: out
cdn: muw yks rxl rps
ffw: nmw ojz scq ybv
ntk: kxr bew tdn qut eef uok ngh vvc qgq fyo aem eti ebe dtm lce
bbm: mdk rue
vto: oox
wut: vju bfp
bns: vwq sit tjr
jdh: ftm ozp jta
wwa: tjr whc sit
iqy: tzk twa xga
qbm: rhg spz kjl xmy glm
njo: cvs ens pre xiy
kzh: wou hiq wmk dcf
fia: qtz ida jdh
etk: ocr lbd tfc sjg
ble: apw kdp
ovc: rhg spz glm
iik: kda
lhn: bmt tam
bso: rio
scq: hjt den rcc
tfn: bir rvu mag
oua: kda dde ntk
jne: mmr qdx raj
qzh: bdl obn wnw
rzf: emg
esw: dot
fhz: frm war
rle: txb yuj
mxc: lbd tfc sjg ocr mjo
emy: ill mzc sjj jlt wav yvj ffw rau ove lwi vrf hlh szs qpt nge
shn: dpt hbn
ied: shn twa xga
crh: wbk
vhs: gun tkp kyb
cyg: zrv
hgl: slf cdn cuj
mrh: lbd sjg mjo
jwm: dhx lag
aid: spv vet
dde: nsw uok gfx qut tdn bew bzt oxj ebe sqr kbs
nhn: gvb xry
qbg: you fsq dpt
gip: zry
lwn: zku pai
wyd: que kng sxx myl
ftj: kyr foc qxt mhi
vet: qtz jdh ida
jue: tmc ajt
fmv: jdr
pes: nge qpt bey szs hlh vrf lwi kxf ove yos mue rau yvj wav zfo sjj ytp lhn wut mzc ill vej
tdn: dry
pyb: jbo ctg lye bjn
qpd: iim emy pes
den: yfw lhg gyb
elf: hel
myo: xry
urz: vlb guj awf
eti: lda nbp
hzi: fmw lwn
